# KEYWORD <TAB> DESCRIPTION
# Sort alphabetical order (case insensitive)
ACK	Acknowledge
am	Active Message
CMA
CUDA	Compute Unified Device Architecture(NVIDIA)
DC	
ep	End Point
gcopy
IB	Infiniband
IPC	Inter Process Communication
KNEM
CMA	Cross Memory Attach
KNEM	Kernel Nemesis
md	Memory Domain
mm	Memory Management
MPI	Message Passing INterface
MPICH	A MPI Implementation
NAK	Negative Acknowledge
OOB	Out of band
OOO	Out of Order
OPA	Omni-Path Architecture
Open MPI	A MPI Implementation
PCIe	PCI Express
PGAS	Partitioned Global Address Space
POSIX
QP	Queue Pair(Infiniband)
RC	Reliable Connection (Infiniband)
RMA	Remote Memory Access
RNR	Receiver Not Ready
RoCE	RDMA over Converged Ethernet
ROCm	Radeon Open Compute platform
Skb	Socket Buffer
SockCM	
SRQ	Shared Receive Queue
SYSV
tl
UC	Unreliable Connection (Infiniband)
UCM	Unified Communication Management
UCP	Unified Communication Protocols Higher level API
UCS	Unified Communication Service Common utilities.
UCT	Unified Communication Transport Lower level API
UD	Unreliable Datagram (Infiniband)
uGNI	user level generic network interface(Cray)
WQE	Work Queue Elements (pronounce WOOKIE)
XPMEM	cross partition memory
Zcopy	Zero Copy
